	xeromorphic
'	None
-	None
--	None
!).	None
!]	None
&	None
(	None
(-	None
(?)	None
)	None
)-	None
-)	None
-)-	None
)(	None
),	None
).	None
)..	None
):	None
);	None
,	None
-,	None
.	None
.,	None
..	None
/	None
:	None
;	None
-?	None
?)	None
?).	None
[	None
[-	None
]	None
-]	None
],	None
].	None
];	None
+	None
=	None
±	None
'±	None
×	None
°	None
°)	None
°,	None
°.	None
0	None
01	None
1	None
10	None
100	None
10x	None
10x7	None
11	None
12	None
13	None
136	None
1378	None
14	None
140	None
14744	None
14966	None
15	None
1596	None
16	None
16494	None
17	None
18	None
19	None
1958	None
1960	None
2	None
20	None
208	None
21	None
22	None
2259	None
23	None
2322	None
24	None
25	None
26	None
27	None
2758	None
28	None
2843	None
3	None
30	None
3196	None
32	None
33	None
3308	None
34	None
35	None
36	None
37	None
38	None
4	None
40	None
41	None
412	None
4178	None
42	None
43	None
44	None
45	None
46	None
469	None
4705	None
48	None
49	None
5	None
50	None
55	None
5986	None
6	None
60	None
62	None
65	None
66	None
6x0	None
7	None
75	None
770	None
78	None
8	None
80	None
8069	None
826	None
89	None
9	None
90	None
9x1	None
a	None
à	None
abondamment	None
abondant	plentiful
abord	None
absence	None
absent	None
abusivement	None
accompagné	None
accrescent	accrescent
accrue	None
actinomorphe	actinomorphic
acu	None
acumen	acumen
acuminata	None
acuminatu	None
acuminé	acuminate
acuta	None
acutu	None
ad	None
adaxial	adaxial
adaxiale	None
adhérent	None
affaissé	None
affini	None
affinitatibu	None
affinité	None
afflni	None
affrontant	None
africaine	None
afrique	None
âgé	None
âgée	None
agréablement	None
aigu	None
aiguë	None
aiguëe	None
aile	wing
ailé	winged
ailée	None
ailleur	None
ainsi	None
aire	None
aisément	None
aisselle	axil
al	None
alabaster	None
alabastro	None
alaire	None
alata	None
alati	None
albumen	None
albuminée	None
alifor	None
aligné	None
aliquotien	None
allongé	long
allongée	None
allongement	None
alor	None
alter	None
alterne	alternate
alternent	None
alterni	None
alternicarpelle	None
alternistémone	None
altu	None
américaine	None
aminci	None
amincie	None
amphistaminal	None
an	None
ancien	None
andongensi	None
androcée	androecium
androgynophore	androgynophore
androphore	androphore
angle	None
angola	None
angu	None
anguleu	None
anguleur	None
anguleuse	None
anneau	annulus
annulairc	None
annulaire	annular
anomalie	None
anormale	None
anthćrc	None
antherae	None
antherarum	None
anthère	anther
antheri	None
anthese	None
anthèse	anthesis
aoûté	None
aoûtement	None
aperturau	None
apex	apex
aphylle	
apicale	None
apicalement	None
apicem	None
apicule	None
apiculé	apiculate
apiculée	None
aplati	flattened
apodostigmum	None
apparemment	None
apparent	None
apparente	None
approche	None
appui	None
aprè	None
aptère	None
arbre	tree
arbrisseau	treelet
arbuscule	None
arbuste	None
arbustif	None
arceau	None
arcuati	None
arête	ridge
arille	aril
armée	None
arqué	arching
arquée	None
arrondi	rounded
arrondie	None
articulation	None
articulatrum	None
articulé	None
ascendant	None
ascendante	None
aspect	None
assez	None
atrophie	None
atrophiée	None
atteignant	None
atteignent	None
atteindre	None
atteint	None
attenuatu	None
atténué	attenuate
atténuée	None
au	None
auriculé	auriculate
auriculée	None
aussi	None
autour	None
autre	None
avant	None
avec	None
avorté	None
avortée	None
avortement	abortion
axe	axis
axiale	None
axile	axile
axillaire	axillary
axillare	None
ayant	None
b	None
ba	None
bacciforme	baccate
baie	None
bande	None
barbu	barbed
barque	None
basai	None
basal	basal
basale	None
base	None
basi	None
basim	None
basse	None
beaucoup	None
bec	None
beige	None
bélinga	None
bellay	None
biapiculé	None
biauriculé	None
biculaire	None
bien	None
bifurcation	None
biho	None
bilobée	None
biovulée	None
bipare	None
biseriati	None
bisérié	biseriate
bisériée	None
blanc	None
blanchâtre	None
blanche	None
bleuâtre	None
bleutée	None
blond	None
blonde	None
bo	None
boi	None
bombé	bulging or convex
bombée	None
bomi	None
bord	None
bordée	None
bosquet	None
bosse	None
bosselé	lobed
bosselée	None
bossu	gibbous
bouquet	None
bourgeon	bud
bourrelet	fold
bout	tip
bouton	bud
br	None
bractea	None
bractée	bract
bractéole	bracteole
bractéolé	None
bractéolée	None
branche	None
branchement	None
bref	None
bréviaxe	None
brevibu	None
breviter	None
brevium	None
breyne	None
brièvement	short, shortly
brillant	shiny
brisée	None
bronzée	None
brun	reddish-brown
brunâtre	None
brune	None
brunissant	None
brusquement	None
buisson	shrub
buissonnante	None
bull	None
c	None
ca	None
cachée	None
caduc	None
caduque	None
calice	calyx
callu	None
calotte	None
calymnée	None
calyptréiforme	None
cambré	None
cameroun	None
camerounaise	None
camerouno	None
campylostemon	None
camu	None
canal	None
canali	None
canaliculati	None
canaliculé	canaliculate
candélabre	None
cannelure	flute
caoutchouc	None
capable	None
capité	capitate
capitellato	None
capitelliforme	None
capsiciformi	None
capsulaire	capsular
capuchon	hood
caractère	None
caractérisé	None
caractériser	None
caractéristique	distinctive
carène	keel (carina)
carêne	None
carminée	None
carnpylostemoneae	None
carpellaire	
carpelle	carpel
carpellé	None
carré	None
cartacé	chartaceous
cassure	None
cathà	None
caudé	caudate
cauliflorie	cauliflory
caulinaire	cauline
cavité	cavity
ce	None
ceint	None
ceinturant	None
ceinturé	None
celastreae	None
celastroideae	None
celle	None
cellé	None
cellée	None
cellule	cell
celui	None
cent	None
central	central
centrale	None
centre	None
cerasiocarpa	None
cercle	None
cerise	None
cerne	ray (of wood)
cerné	None
certain	None
certaine	None
cet	None
cette	None
ceu	None
ceylan	None
cfr	None
chacun	None
chacune	None
chagriné	
chagrinée	None
chaînette	None
chalaze	chalaza
champ	None
chapeau	None
chaque	None
charnu	fleshy
charnue	None
chartacé	chartaceous
chartacée	None
chevauchant	None
chevron	None
chez	None
ci	None
cicatrice	scar
ciflore	None
cil	hair, fine
cilié	ciliate
ciliée	None
ciliolata	None
ciliolé	
ciliolée	None
cime	None
circulaire	circular
cireu	None
citra	None
citron	None
clair	None
claire	None
clare	None
clé	None
cloison	partition
cm	None
co	None
coeur	None
coiffant	None
coiffé	None
coin	None
col	None
collatérau	None
collerette	None
colonne	column
colore	None
coloré	None
colorée	None
colporée	None
columelle	columella
comestible	edible 
comme	None
commun	None
complémentaire	None
complète	None
complexe	intricate blooms
compliquée	None
comporte	None
composée	None
comprenant	None
compression	None
compri	None
comprimé	compressed
comprimée	None
comprise	None
compte	None
concave	concave
concentrique	None
concolor	None
concolore	None
cône	cone
confirmer	None
confluent	None
confluentibu	None
confondant	None
conforme	None
confusément	None
conglomeratae	None
coni	None
conique	conical
conjuncti	None
connaisson	None
conné	connate
connectif	connective (of stamens)
connée	None
conni	None
connivent	connivent
connu	None
connue	None
conservant	None
conspicua	None
constric	None
constriction	None
contact	None
contenant	None
contient	None
contigu	None
contiguë	None
continu	None
continue	None
contour	None
contournant	None
contourné	contorted
contractée	None
contraire	None
contribue	None
convergeant	None
convergent	convergent
convexe	convex
convolutée	None
copieu	None
corail	None
cordata	None
cordé	cordate
cordée	None
cordiforme	heart-shaped
coriace	leathery
corne	None
corolle	corolla
cortical	
corymbe	corymb
costae	None
costé	None
côte	None
côté	None
cotylédon	cotyledon
cotylédonaire	None
cotylédonée	None
couche	layer
couchée	None
couleur	None
coupe	None
courbant	None
courbée	None
couron	None
couronne	crown
couronné	None
court	None
courte	None
courtement	None
coussin	None
coussinet	None
couture	None
couvert	None
couvrant	None
craquelé	None
craquelée	None
crème	None
crénelé	crenate
crénelée	None
crénulée	None
crête	None
creusé	excavated
crevassé	crevice
crevassée	None
criblé	pitted
crispé	
crispée	None
crispulati	None
cristé	None
crochet	hook
croissant	None
ct	None
cucullé	hooded
cucumiforme	None
cuiller	None
cuivré	coppery
cule	None
culé	None
culée	None
culminale	None
cum	None
cunéiforme	wedge-shaped
cupu	None
cupulaire	cupular
cupule	cupule
cupuli	None
cupuliforme	cup-shaped, short
cupuliformi	None
curieuse	None
curieusement	None
cylindre	None
cylindrique	cylindrical
cylindroconique	None
cyme	cyme
cymeur	None
cymule	cymule
d	None
dan	None
dare	None
dc	None
de	None
dè	None
de4	None
debili	None
débordant	None
début	None
décagonal	None
déchirant	None
déchiré	None
décombant	decumbant
décrite	None
décurrent	decurrent
décussée	None
dédoublé	None
définissable	None
déformé	None
dégradée	None
dehiscence	None
déhiscence	dehiscent
dèhiscence	None
déhiscent	dehiscent
déhiscente	None
dehiscentibu	None
deinde	None
déjà	None
delà	None
délimitant	None
deltoïde	deltoid
demi	None
dense	None
densément	None
dent	None
dentati	None
denté	dentate
dentée	None
dentelé	
denti	None
denticu	None
denticule	None
denticulé	denticulate
denticulée	None
dépassant	None
dépasse	None
dépassent	None
dépasser	None
dépourvu	None
dépourvue	None
dépression	depression
déprimé	depressed
depui	None
dernier	None
dernière	None
désagréable	None
descendant	None
description	None
dessou	None
dessu	None
détachant	None
détachent	None
deu	None
développé	None
développée	None
développement	None
devenant	None
diagnose	diagnosis
diam	None
diamètrc	None
diamètre	None
dichasiale	dichasial
dichotome	None
dichotomie	None
dichotomique	dichotomous
différant	None
diffère	None
différence	None
différencié	None
différent	None
diffèrent	None
differt	None
difficile	None
difficilement	None
difforme	None
dimension	None
dimidiae	None
dina	None
directement	None
discale	None
disciforme	disciform
disco	None
discolore	discolorous
discontinu	None
discontinue	None
discu	None
disposé	None
disposée	None
disque	disc
dissimulant	None
dissociant	None
dissymétrique	None
distal	None
distale	None
distant	None
distinct	None
distincte	None
distinctement	None
distingue	None
distinguée	None
distinguer	None
dit	None
divari	None
divariquée	None
diver	None
divergent	divergent
divisé	None
divisée	None
division	None
dominant	dominant
dominée	None
doni	None
donnée	None
donnent	None
dont	None
dorée	None
dorsalement	None
double	double
doute	None
douteu	None
drangulaire	None
dressé	erect
dressée	None
droit	upright
droite	None
drupacé	drupaceous
drupe	stone fruit
du	None
due	None
duquel	None
e	None
écaille	scale
écaillé	None
écailleu	None
écailleuse	None
écarlate	None
échancré	
échancrée	None
échancrure	notch
échantillon	None
échelonné	None
échelonnée	None
échinulé	echinulate
échinulée	None
écorce	bark
écusson	
effilée	None
effrangé	None
effrangée	None
égal	None
égale	None
égau	None
élargi	None
élargie	None
elatior	None
élément	None
élémentaire	None
élevant	None
élevé	None
élevée	None
elle	None
ellipsoïde	ellipsoid
elliptica	None
elliptique	elliptic
elongatu	None
émarginé	emarginate
émarginée	None
émarginulé	None
embrassant	clasping 
embrassée	None
embryon	embryo
embryonnaire	None
émoussé	None
émoussée	None
empreint	None
en	None
enchâsse	None
encolure	None
encore	None
endocarpique	None
enfin	None
enfoncé	None
enfoncée	None
enrobée	None
enroulant	None
enroulé	inrolled
enroulée	None
enroulement	None
ensuite	None
entier	entire
entière	None
entièrement	None
entourant	None
entouré	None
entourée	None
entre	None
entrenoeud	None
enveloppant	None
environ	None
épai	None
épaissant	None
épaisse	None
épaissessement	None
épaisseur	None
épaissi	thickened
épaississement	None
épanouie	None
épanouissement	None
épanouit	None
épaté	None
épiderme	epidermis
épigé	epigeal
épigée	None
épine	thorn
épineu	None
équivalent	None
erectu	None
érigé	None
érigée	None
érodé	None
érodée	None
espacé	None
espacée	None
espèce	species
essentiellement	None
est	None
estompant	None
et	None
étagée	None
étalant	None
étalé	spread
étalée	None
etamine	None
étamine	stamen
êtamine	None
ëtamine	None
ētamine	None
étant	None
été	None
étendu	None
étirée	None
étoilé	star-shaped
étoilée	None
étranglé	constricted
étranglement	None
être	None
étroit	None
étroite	None
étroitement	None
étudié	None
étui	None
eu	None
évasé	None
évasée	None
ex	None
exactement	None
exalbuminée	None
exception	None
exceptionnel	None
exceptionnellement	None
excurvé	None
exine	exine
exocarpe	exocarp
exserte	exserted
extensu	None
extérieur	None
extérieurement	None
externe	None
extra	None
extrapétiolaire	None
extrastaminal	None
extrême	None
extrémité	None
extrorse	extrorse
fa	None
face	None
façon	None
faible	None
faiblement	faintly
fait	None
famille	None
fandrocée	None
fascicule	fascicle
fasciculée	None
fasciculi	None
fauve	None
fécondation	fertilization
félix	None
fendu	cracked
fendue	None
fent	None
fente	slit
fere	None
fère	None
ferrugineuse	None
fertile	None
festiva	None
festonné	None
festonnée	None
feuille	leaf
feuillé	leafy
feuillée	None
fibre	fibre
fibreu	None
fibrovasculaire	None
fig	None
fil	None
filament	None
filamenti	None
filamentibu	None
filet	filament
filore	None
fimbrié	fimbriate
fimbriée	None
fimbriolé	None
fimbriolée	None
fin	None
fine	None
finement	None
fiore	None
fissurée	None
flabellé	fan-shape
flabellée	None
flabelliforme	fanned
fleur	flower
flo	None
floraison	None
floral	None
florale	None
florau	None
flore	None
floribu	None
florifère	None
foi	None
foliacea	None
foliaire	leaf-
folii	None
folium	None
foncé	None
foncée	None
fond	None
forestière	None
formant	None
forme	form
formé	None
formée	None
former	None
fort	None
fortement	strongly
fossette	None
fossulé	None
fourche	None
fourni	None
fracturant	None
fradi	None
fragile	delicate
frangé	fringed
fréquemment	None
fréquente	None
fripé	None
fructibu	None
fructu	None
fruit	fruit
frutex	None
funiculaire	None
furqué	None
fusiforme	spindle-shaped
fusiformibu	None
g	None
gabon	None
gabonaise	None
galle	None
gallé	None
gaufré	
gemmule	plumule
général	None
généralement	None
genre	None
germination	germination
glaber	None
glabre	glabrous
glabrescent	glabrescent
glande	gland
glandulaire	glandular
glanduleu	None
glanduleuse	None
glandulifère	None
glanduligère	None
glanduloso	None
glauque	glaucous
globoïde	None
globuleu	None
globuleuse	None
glomérule	glomerule
glomeruli	None
goitre	None
gouttière	None
gr	None
gracile	slender
gracilibu	None
graciliflora	None
graine	seed
gramme	None
grand	None
grande	None
granuleu	None
grappe	raceme
grêle	slender
grenu	None
grenue	None
gri	None
griffon	None
grisâtre	None
grise	None
gro	None
grosse	None
grossier	None
grossière	None
grossièrement	coarsely
groupe	None
groupée	None
groupement	None
guinée	None
guttulée	None
gynandrocée	None
gynandrophore	None
gyne	None
habituel	None
habituellement	None
hallé	None
haud	None
haussé	None
haut	None
haute	None
hauteur	None
hcrbier	None
helictonemae	None
helictonemum	None
héliophile	
herbier	None
hermaphrodite	hermaphrodite
hill	None
hippocratea	None
hippocrateà	None
hippocratéacée	None
hippocrateae	None
hippocrateoideae	None
hirsute	hirsute
hispide	hispid
hist	None
homogène	None
horizontal	None
horizontau	None
howesio	None
hypogé	hypogeal
hypogée	None
ici	None
il	None
îlot	None
imbriqué	imbricate
imbriquée	None
immature	None
immersi	None
imprimée	None
in	None
inaequalibu	None
inaequalïbu	None
inaequalium	None
incluant	None
inconnu	None
incrassato	None
incurvée	None
inde	None
indéfinie	None
indentation	None
indépendant	None
indica	None
indiqué	None
indistinct	obscure
indistincte	None
indistinctement	None
inégale	None
inégalement	None
inégau	None
inerme	unarmed
inférieur	None
inférieure	None
inflorescence	inflorescence
inflorescentiae	None
inflorescentiel	None
inflorescentii	None
infrutescence	infructescence
initiale	None
inséré	inserted
insérée	None
insèrent	None
inserti	None
insertion	None
inspirée	None
insuffisamment	None
intercarpellaire	None
interdum	None
intérieur	None
intermédiaire	None
interne	None
internodium	None
interpétalaire	None
interrompu	None
interrompue	None
intersecondaire	None
intervalle	None
intra	None
intradiscale	None
introrse	introrse
intu	None
irrégulier	None
irrégulière	irregular
irrégulièrement	None
issu	None
ivoire	None
jacque	None
jaunâtre	None
jaune	None
jeune	None
jointif	None
jointive	None
jolly	None
jusqu	None
jusque	None
juste	None
juvénile	None
juvenilibu	None
juxtaposé	None
juxtaposée	None
katanga	None
klaine	None
l	None
la	None
lacérée	None
lâche	lax
lâchement	None
lacinié	laciniate
lacune	lacuna (leaf gap)
lacuneu	None
laeviaque	None
laevibu	None
lageniforme	None
lagéniforme	
laire	None
lamellé	None
lamelleur	None
lamina	None
laminée	None
lancéolé	lanceolate
lancéolée	None
lanière	strip
large	None
largement	None
largeur	None
lata	None
late	None
latéral	lateral
laterale	None
latérale	None
latéralement	None
laterali	None
latérau	None
latex	latex
lati	None
le	None
lé	None
lée	None
leeuwenberg	None
léger	None
légère	None
légèrement	None
len	None
lent	None
lenti	None
lenticelle	lenticel
lenticellé	lenticellate
lenticellée	None
leonensi	None
lequel	None
letouzey	None
leu	None
leur	None
lèvre	None
liana	None
liane	liana
lianescente	None
libère	None
liberium	None
libre	free
lié	None
liée	None
liège	None
ligne	None
ligneu	None
ligneur	None
ligneuse	None
limbe	limb
lippue	None
lisse	smooth
littorale	None
littorau	None
lobć	None
lobe	None
lobé	None
lobée	None
lobule	None
lobulé	None
lobulée	None
locelle	None
locellée	None
loculi	None
loculicide	loculicidal
loculo	None
loe	None
loesener	None
loeseneriella	None
loge	None
long	None
longae	None
longe	None
longeant	None
longï	None
longipedi	None
longitudinal	None
longitudinale	None
longitudinalement	None
longitudinau	None
longtemp	None
longu	None
longue	None
longuement	long
longueur	None
longum	None
lonné	None
lor	None
loui	None
loupe	None
luisant	None
lulaire	None
m	None
magni	None
mai	None
maigre	None
majoribu	None
malgré	None
mamelonné	None
manifestement	conspicuous 
marbrure	None
marge	None
marginal	marginal placentation
marginale	None
marginalement	None
marginau	None
marginé	None
marginée	None
marginibu	None
marque	blotch
marqué	None
marquée	None
masquent	None
masse	None
massif	None
mate	None
matériau	None
matériel	None
mathew	None
matique	None
maturité	None
maximi	None
me	None
médian	None
médiane	main nerve
médiocre	None
médiocrement	None
mediocribu	None
mediocriter	None
mélange	None
membrane	None
même	None
ment	None
mère	merous
méricarpe	mericarp
méridien	None
méritent	None
mériter	None
mesurer	None
mi	None
microapiculé	None
microapiculée	None
microcilié	None
microciliolé	None
microdenticulé	None
microdenticulée	None
microéchinulé	None
microfimbriolé	None
microfrangé	None
microlobulé	None
micropapilleu	None
micropapilli	None
micropapillifère	None
microphylle	None
micropubéru	None
micropubérulent	None
micropustuleu	None
microruguleu	None
microscopique	None
microverruculeu	None
mier	None
mildbraed	None
milieu	None
minau	None
mince	thin
miné	None
minimi	None
minoribu	None
minuscule	minut
minute	None
mm	None
modèle	None
modeste	None
modestu	None
moin	None
moitié	None
monade	None
mone	None
monosperme	None
montrant	None
morcelée	None
mortehanio	None
moucheté	mottling
mouchetée	None
moulant	None
moyen	None
moyenne	None
moyennement	None
mu	None
mucilage	mucilage
mucilagineuse	None
mucron	mucron
multibracteolatae	None
multibractéolé	None
multibractéolée	None
multidentée	None
multiflorae	None
multiflore	flowered, many-
multiflori	None
multilobulé	None
multinervié	None
multio	None
multisil	None
multisillonné	None
mundele	None
muni	None
munie	None
mûr	None
muriqué	muricate
n	None
nat	None
natn	None
ne	None
nectar	nectar
nectarifère	nectariferous
ner	None
nervation	venation
nervé	None
nervi	None
nerville	veinlet
nervure	vein
net	None
nette	None
nettement	markedly
ni	None
nigérien	None
nigre	None
nigrisilvae	None
nipétale	None
nique	None
nitida	None
niveau	None
noeud	None
noir	None
noirâtre	None
noircissant	nigrescent
noircissante	None
noircissent	None
noire	None
nom	None
nombre	None
nombreu	None
nombreur	None
non	None
normal	None
normale	None
normalement	None
nota	None
notamment	None
note	None
nou	None
nouai	None
nouaison	None
noué	None
nsi	None
nul	None
obaton	None
obcurément	None
obdeltoïde	None
oblique	None
obliquement	None
oblong	oblong
oblongue	None
obovale	obovate
obové	None
obovoïde	None
observable	None
observe	None
observé	None
observée	None
observer	None
obtron	None
obtu	None
obtuse	None
obtusément	None
obtusi	None
occasionnellement	None
occupé	None
ochracé	None
ochracée	None
ocracé	None
ocracée	None
ocre	ochre 
odeur	None
odorant	fragrant
odorante	None
odoriférante	None
olivacé	None
olivacea	None
olivacée	None
olivâtre	None
olive	None
oliver	None
on	None
ondulé	wavy
ondulée	None
onglet	claw
onguiculé	clawed
onguiculée	None
ont	None
opaque	None
ophiurella	None
oppo	None
opposé	opposite
opposée	None
opposent	None
opposita	None
oppositipétale	None
oppositisté	None
oppositistémone	None
orange	None
orangé	orangey
orangée	None
orbiculai	None
orbiculaire	orbicular
ordinairement	None
oreillette	None
organe	None
orientale	None
orientali	None
orienté	None
orientée	None
originale	None
orné	None
ornée	None
ornementation	ornamentation
ornementé	None
orthotrope	orthotropus
ou	None
où	None
ouest	None
ouvert	open
ouverte	None
ouvrant	None
ouvrir	None
ovairc	None
ovaire	ovary
ovale	ovate
ovario	None
ovarium	None
ovata	None
ové	None
ovée	None
ovo	None
ovoïde	None
ovula	None
ovulati	None
ovule	ovule
ovulée	None
ovuli	None
p	None
pa	None
paire	None
pâle	None
pallescenti	None
pallidioribu	None
pallidu	None
pani	None
panicule	panicle
paniculée	None
paniculiforme	paniculate
panthèse	None
papille	None
papilleuse	None
papillifère	None
papyracé	papery
par	None
paraissant	None
parallèle	None
parenchymateu	None
parenchymateur	None
parenchyme	parenchyma
parfaitement	None
parfoi	None
pari	None
paroi	wall
partagée	None
particularité	None
particulière	None
particulièrement	None
partie	None
parvae	None
parvo	None
parvu	None
patelli	None
patelliforme	
pau	None
pauci	None
pauciciliolé	None
pauciciliolée	None
paucidenté	None
paucidenti	None
paucidenticulé	None
pauciflorae	None
pauciflore	flowered, few-
paucinervié	None
paulum	None
pédi	None
pédicel	None
pédicellaire	None
pedicelle	None
pédicelle	pedicel
pédicellé	stipitate
pédicellée	None
pedicelli	None
pedicellum	None
pédon	None
pédoncule	peduncle
pédonculé	stalked
pédonculée	None
pedunculati	None
pedunculi	None
peine	None
pendant	pendulous
pengyne	None
penninerve	None
pentagonal	pentagonal
pentagonale	None
pentagonali	None
pentamère	None
perbrevi	None
perbrevibu	None
péri	None
périanthaire	None
périanthe	None
péricarpe	pericarp
périgine	None
perigyna	None
périgyne	perigynous
permet	None
persistant	persistent
persiste	None
persistent	None
pérulaire	None
pérule	None
pesant	None
petala	None
pétalaire	None
pétale	petal
pétaloïde	petaloid
pétio	None
pétiolaire	None
pétiole	petiole
pétiolée	None
petioli	None
petiolo	None
petiolorum	None
petit	None
petite	None
peu	sparsely
peut	None
pièce	None
pied	None
pileu	None
pincé	None
pincée	None
piqueté	None
piquetée	None
piriforme	pear-shaped
pistil	pistil
pistillum	None
pl	None
placentaire	None
placentation	placentation
plage	None
plagiotrope	None
plan	None
plant	None
plante	None
plantule	seedling
plat	None
pleurostylium	None
pli	None
plié	folded
plissé	corrugated
plissée	None
plombé	None
plu	None
plupart	None
pluri	None
pluricel	None
pluricellulaire	None
pluriflo	None
pluriflore	
plusieur	None
plutôt	None
poid	None
poil	None
point	patch
pointe	tip
pollen	pollen
polyade	None
polyédrique	None
ponctiforme	None
pore	pore
poré	None
porée	None
port	None
portant	bearing
porte	None
porté	None
portée	None
porteur	None
position	None
postérieurement	None
poulie	None
pour	None
pourpre	purple
pourtant	None
pourvu	None
pourvue	None
pouvant	None
pratiquement	None
prè	None
précédente	None
préfloraison	prefloration (aestivation)
préhensile	None
première	None
prenant	None
présence	None
présent	None
présentant	None
présente	None
présentent	None
presque	None
preussio	None
principale	None
principau	None
pristimera	None
probable	None
probablement	None
proche	None
produit	None
profond	None
profonde	None
profondément	None
profondeur	None
prolonge	None
proprement	None
protandre	None
protandrie	protandry
protège	None
protubérance	protuberance
proue	None
provient	None
proximale	None
pruine	pruinose
pruineu	None
pseudodisque	None
pubé	None
pubérulence	None
pubérulent	
pubescence	pubescence
pubescent	pubescent
pubescente	None
pui	None
pulpe	pulp
pulpeur	None
pulvinato	None
pur	None
purébulent	None
pustuleu	None
pyramidal	pyramid, of a
pyramidale	None
pyramide	None
pyriforme	None
qu	None
qua	None
quadrangu	None
quadrangulaire	squarish
quadrangulata	None
quart	None
quartier	None
que	None
quée	None
quelque	None
quelquefoi	None
qui	None
quinconcial	None
quinconciale	None
quinconciau	None
quoque	None
r	None
rabattant	None
rachi	None
radicule	
raide	stiff
rameau	twig
rameu	None
rameur	None
rami	None
ramification	branching
ramifiée	None
ramulae	None
ramule	None
ramuli	None
ramulosae	None
ramusculo	None
rang	None
rangée	None
raphé	raphe
rapidement	None
rappelant	None
rapport	None
rapportée	None
rapportent	None
rapprochée	None
rapprochent	None
rare	None
rarement	None
rase	None
rayon	None
rayonnant	None
re	None
rebord	rim
rebordé	None
rebordée	None
réceptacle	None
récolte	None
récolté	None
reconnaissable	None
reconnue	None
recouvrant	None
recouvrante	None
rectangulaire	None
recto	None
réduire	None
réduit	reduced
réduite	None
rée	None
réfléchi	reflexed
réfléchie	None
réfractant	None
réfracté	None
refracti	None
régulière	None
régulièrement	None
rehaussement	None
réhydratation	None
réhydraté	None
réhydratée	None
reissantium	None
réitérer	None
rejeté	None
relevé	None
relevée	None
relief	None
remarquable	None
remarquablement	None
remontée	None
remplacé	None
rempli	None
remplie	None
remplissage	None
rendu	None
renflée	None
réniforme	reniform
repli	None
réseau	network
restant	None
reste	None
restent	None
réticule	None
réticulée	None
retombant	lax
rétréci	shrunk
rétrécie	None
rétu	None
révoluté	revolute
rhodesiaca	None
rhombo	None
rhytidome	rhytidome
riche	None
ride	None
ridé	wrinkled
rimi	None
ripicole	None
robuste	stout
rosâtre	None
rose	None
rosé	pinkish
rosée	None
rostre	None
rostré	beaked
rostrè	None
rotacé	rotate
rotacée	None
rou	None
rouge	None
rougeâtre	None
roulé	None
roussâ	None
roussâtre	None
rousse	None
rubané	ribboned
ruber	None
rude	None
rugueu	None
rugueur	None
rugueuse	None
ruguleu	None
rulent	None
sa	None
sagittée	None
saillant	raised
saillante	None
saillie	None
salacium	None
salarium	None
san	None
sarmenteu	None
sarmenteur	None
sâtre	None
sauf	None
saumon	None
saumoné	None
saumonée	None
scabre	scabrous
schaije	None
sciaphile	shade-tolerant
se	None
sec	dry
séchage	None
secondaire	None
secteur	None
sed	None
sedpetioli	None
segment	segment
selle	None
selon	None
semblable	None
sembleraient	None
semi	None
séminal	None
sensiblement	None
sensu	None
sepala	None
sépale	sepal
sepali	None
séparable	None
séparant	None
separatae	None
separato	None
sépare	None
séparé	None
séparée	None
séparément	None
séparer	None
série	None
sérié	seriate
serré	tightly
serrulée	None
sessile	sessile
sessilibu	None
sessilium	None
seule	None
seulement	None
sève	saprophyte
sexe	None
si	None
sillon	None
sillonné	furrowed
similaire	None
simple	simple
simplement	simply
singulari	None
sinu	None
sinueu	None
sinueur	None
sinueuse	None
sinuosité	None
sitistémone	None
situćc	None
située	None
six	None
smith	None
socle	None
soit	None
sol	None
solitaire	solitary
sommet	apex
son	None
sont	None
sorte	None
sou	None
soude	None
soudé	None
soudée	None
soufre	sulphur
soulignant	None
souligné	lineate
souple	supple
souplesse	None
souvent	None
spatulé	spatulate
spatulée	None
spécialement	None
specie	None
sphaerici	None
sphéri	None
sphérique	spherical
spirale	None
spiralé	spiral, spiraled
spiralée	None
spongieuse	None
squameu	None
squameuse	None
sta	None
stade	None
stamina	None
staminae	None
staminale	None
staminau	None
stérile	sterile
stig	None
stigmatc	None
stigmate	stigma
stigmatique	stigmatetic
stigmato	None
stipule	stipule
strie	None
strié	striated
striolé	None
structure	None
structuré	None
style	style
stylu	None
sub	None
subactinomorphe	None
subacuminé	None
subaigu	None
subaiguë	None
subailé	None
subaliforme	None
subanguleu	None
subanguleuse	None
subapicale	None
subapicalement	None
subapiculé	None
subarrondie	None
subcapité	None
subcharnu	None
subcirculaire	None
subcitriformibu	None
subcon	None
subconcolore	None
subconique	None
subcordée	None
subcoriace	None
subcorymbiforme	None
subcrénelé	None
subcrénelée	None
subcucullé	None
subcunéiforme	None
subcupulaire	None
subcupuliforme	None
subcylindrique	None
subdeltoïde	None
subdenté	None
subdentée	None
subdenticulé	None
subdiscolore	None
subdivisée	None
subégau	None
subentier	None
subentière	None
subéquiaxe	None
subéreu	None
subéreur	None
subérigé	None
subérigée	None
subétalé	None
subétoilé	None
subeupuliforme	None
subfiliforme	None
subfimbrié	None
subflavescentibu	None
subflavi	None
subgloboïde	None
subglobosu	None
subglobuleu	None
subglobuleur	None
subhexagonal	None
sublacinié	None
sublancéolé	None
sublauriforme	None
sublisse	None
submuriqué	None
subobtu	None
subobtuse	None
subombelliforme	None
subonguiculé	None
subopposée	None
suboppositi	None
subor	None
suborbiculai	None
suborbiculaire	None
suborbicularibu	None
subové	None
subparallèle	None
subpen	None
subpentagonal	None
subpentagonale	None
subpentagonatu	None
subperpendiculaire	None
subpétaloïde	None
subpolygonau	None
subponctiforme	None
subpyramidal	None
subréniforme	None
subroseu	None
subrostré	None
subrotacée	None
subsarmenteu	None
subsemiorbiculaire	None
subsessile	sub-sessile
subsessili	None
subsessilibu	None
subsessilium	None
subspatulé	None
subsphérique	None
subtentier	None
subtransversale	None
subtransverse	None
subtransversi	None
subtranverse	None
subtriangulaire	None
subtricosté	None
subtrigone	None
subtronconico	None
subtronconique	None
subtronqué	None
subulatum	None
subulé	subulate
subulée	None
subval	None
subverruqueu	None
successif	None
succession	None
successive	None
sucré	None
sucrée	None
suglobuleu	None
suhypogée	None
suit	None
suite	None
suivant	None
sulca	None
sulcato	None
supère	superior
supérieur	None
supérieure	None
superposé	None
superposita	None
superum	None
supplémentaire	None
supra	None
sur	None
surbaissé	None
surface	None
surmonte	None
surmonté	topped
surnuméraire	None
surtout	None
susceptible	None
symétriquement	None
symoen	None
t	None
tache	None
taché	None
tacheté	spotted
tagonal	None
taille	None
tangent	None
tantôt	None
tapissée	None
tardivement	tardily
tassé	None
tégument	tegument
tend	None
tendance	None
tendent	None
terminal	None
terminale	terminal
terminau	None
terminé	None
terne	None
testa	testa
testu	None
tétrade	None
texture	None
the	None
theci	None
thèque	theca
thèse	None
thyrse	thyrse
ticelle	None
tier	None
tige	stem
tissu	None
tomentelleuse	None
tomenteu	None
tomenteuse	None
tonnelet	None
tordant	None
tordue	None
toriforme	None
torrueur	None
tortueur	None
tôt	early
total	None
totale	None
tou	None
toucher	None
toujour	None
toupie	None
tournée	None
tout	None
toute	None
transalaire	None
translucide	None
transparence	None
transversae	None
transversal	None
transversale	None
transversalement	None
transverse	None
trapèze	None
traversant	None
traversée	None
tre	None
trè	None
trentaine	None
tri	None
triangulaire	triangular
tricarpellé	None
tricol	None
tricolpo	None
tricolporé	None
tricolporée	None
tricostulé	None
trièdre	None
triédrique	None
trifide	trifid
triflore	None
trifurqué	None
trigone	trigonous
trilobé	trilobed
trilobée	None
trilobulé	None
triloculaire	trilocular
trimère	None
triporé	None
tristemonanthu	None
troi	None
tronc	trunk
tronco	None
tronconique	None
tronqué	truncate
tu	None
tubercule	tubercle
tubulé	
tubuleuse	None
tubulure	None
turbiné	turbinate
type	type
typica	None
typique	None
ulé	None
ultime	None
un	None
une	None
uni	uni
unie	None
uniflore	None
uniformément	None
uniovulée	None
unisériée	None
unisexuée	None
unité	None
urcéolé	urceolate
urcéolée	None
utrinque	None
vaire	None
valde	None
valeur	None
valvaire	valvate
valvc	None
valve	valve
var	None
variable	None
variant	None
variation	None
varie	None
variété	None
végétation	None
vel	None
veloutée	None
velu	hairy
velue	None
vent	None
ver	None
verdâtre	None
vérifier	None
véritable	None
vermillon	None
verniculeu	None
vernissé	glossy
vernissée	None
verruculeu	None
verruculeur	None
verruculosu	None
verrue	None
verruqueu	None
verruqueuse	None
verso	None
vert	None
verte	None
verticale	None
verticalement	None
vestige	None
vêtu	None
vêtue	None
vieille	None
vieu	None
vif	None
vigoureu	None
vigoureuse	None
ville	None
villosité	None
violacé	purplish-blue
violacée	None
violet	None
violette	None
virant	None
viridi	None
visible	None
vivo	None
vix	None
voir	None
voire	None
voisine	None
volkensiana	None
volume	None
volumineu	None
voorhoeve	None
vu	None
vue	None
vulée	None
wag	None
whytei	None
wilczek	None
x	None
x7	None
y	None
yaun	None
zaïre	None
zenker	None
zimbabwe	None
zone	None
zoné	None
zygomorphie	zygomorphy
μm	None
